1111111111111111111111111111111111
1E0000000000000C000000C10000000001
1111000100100000101111110000010101
1001000010101010001001000000010101
1P00000C0000C0000000000000000001C1
1111111111111111111111111111111111
