1111111111111111111
10000000C0000001111
1111011111000001111
11C00000C0000P01111
1111000000000E01111
10001111101100000C1
1111111111111111111
