11111111111111111111111111111111111111111111111111111111111111111111111
1E001000100000100000000000000000100000001000001000001000100010001000101
10101010111010101111111011111110101111111010101011101010101010101010101
10100010000010101000101000000010001000001010100010001010101010100010101
10111111111111101010101111111010111011101010111110111010101010111110101
10100000100000001010100000001010100010001010000010001010001010100010101
10101110101111111010101111101011101110111011111011101111111010101110101
10101010101000000010001000101010001010000010001000100000100010101000101
10101010101011101110111010111010111011111110101110111110101110101011101
10100010101000100010100010000010000010000000100010100000100010101010001
10111010101110111010101111111011111010111111111010101111111010101010101
10000010101000001010101000000C00001010000010001010100000000010100010101
10111110101111111010101011111111111010111010101110111111111110101110111
10100010100010000010101000100000000010001010100000100000001000100010001
11101010111010111111101011101111111111111010111110101111101011111011101
10001010001010100010001010001000000000000010001000101000101000001000101
10111010111010101010111110111011111010111111101110101010101111101110101
10001000100010101010001000101010001010000000100010100010100000101000101
11101110101110101011101011101010101111101010111010111110111011111011101
10001000101000101010001000100010100000101010100010101000100010000010001
10111111101110101010101110101110111110101010101110101011101110111111101
10000000001000101000100010100010001000101010101000001000100000100010001
10111111111011101111111010111111101011111011101011111110111111101010101
10001000000010001000001010001000001010000010001000100010001000001010101
11101110111110111011101011101011111010101010111111101011101111101010101
10100000100000100000100000101010001010101010000000001000100000001000101
10111110101111111110111111101010111010101111111111111110111111111111101
10000000100010001000000010001010100010100000001000001010100010001000101
10111111111010101111111110111010101111111110101110101010101010101010101
100000000010001000000000000000100000000000001000001000100010001000100P1
11111111111111111111111111111111111111111111111111111111111111111111111